+---+---+---+---+---+---+---+---+
|   .   .   .   .   .   .   .   |
+ . + . + . + . + . + . + . + . +
|   .   .   .   .   .   .   .   |
+ . + . + . + . + . + . + . + . +
|   .   .   .   .   .   .   .   |
+ . + . + . + . + . + . + . + . +
|   .   .   .   .   .   .   .   |
+---+---+---+---+ . + . + . + . +
|       |       |   .   .   .   |
+   +   +   +   + . + . + . + . +
|   |   |   |   |   .   .   .   |
+   +   +   +   + . + . + . + . +
|   |       |   |   .   .   .   |
+   +---+---+   + . + . + . + . +
| S | G         |   .   .   .   |
+---+---+---+---+---+---+---+---+
