+---+---+---+---+
|       |       |
+   +   +   +   +
|   |   |   |   |
+   +   +   +   +
|   |       |   |
+   +---+---+   +
| S | G         |
+---+---+---+---+
