+---+---+---+---+---+---+---+---+
|       |           |         G |
+   +---+---+---+---+   +---+---+
|                   |       |   |
+   +---+---+---+   +---+   +   +
|               |           |   |
+---+   +---+---+   +---+   +---+
|   .           |   |           |
+---+---+---+   +   +   +---+   +
|               |   |       |   |
+   +---+   +---+   +   +---+   +
|   |   |   |   |   |           |
+   +   +   +   +   +---+   +---+
|   |   |       |           |   |
+   +   +   +---+---+---+   +   +
| S |                       |   |
+---+---+---+---+---+---+---+---+
