+---+---+---+---+---+---+---+---+---+
|   |   |           |               |
+   +   +   +   +   +   +---+---+   +
|           |   |   |           |   |
+   +   +   +   +   +---+---+   +   +
|   |   |           |       |   |   |
+   +   +   +   +   +   +   +   +   +
|           |   |       |       |   |
+   +   +   +   +   +---+---+---+   +
|   |   |           |   |       |   |
+   +   +   +   +   +   +   +   +   +
|           |   |   |       |   |   |
+   +   +   +   +---+   +   +   +   +
|   |   |       |       |   |   |   |
+   +---+---+---+   +---+   +   +   +
|   |       |       |       |   |   |
+   +   +   +   +---+   +---+   +   +
| S | G                     |       |
+---+---+---+---+---+---+---+---+---+
