+---+---+---+---+---+---+---+---+---+
|   |       |       |       |     G |
+   +   +   +   +   +   +   +   +   +
|       |       |       |       |   |
+   +   +   +   +   +   +   +   +   +
|   |       |       |       |       |
+   +---+---+---+---+---+---+---+---+
|       |       |       |       |   |
+   +   +   +   +   +   +   +   +   +
|   |       |       |       |       |
+   +   +   +   +   +   +   +   +   +
|       |       |       |       |   |
+---+---+---+---+---+---+---+---+   +
|   |       |       |       |       |
+   +   +   +   +   +   +   +   +   +
|       |       |       |       |   |
+   +   +   +   +   +   +   +   +   +
| S |       |       |       |       |
+---+---+---+---+---+---+---+---+---+
