+---+---+---+---+---+---+---+---+---+---+---+---+---+---+---+---+---+---+---+---+---+---+---+---+---+---+---+---+---+---+---+---+
|                       |                               |               |                   |               |                   |
+---+   +---+---+   +---+   +---+---+---+---+   +---+---+   +---+   +---+   +---+   +---+   +   +   +---+   +   +---+   +---+   +
|       |           |       |               |                   |           |   |   |       |   |       |   |       |       |   |
+   +   +---+---+   +   +---+---+   +---+---+---+---+---+---+---+   +---+---+   +   +---+---+   +---+   +---+---+   +---+   +   +
|   |   |       |   |           |                       |       |               |       |       |   |   |       |   |   |   |   |
+   +---+   +   +---+---+---+   +---+---+   +---+---+   +   +   +   +---+---+   +---+   +   +---+   +   +   +   +   +   +   +---+
|   |       |               |               |       |   |   |   |   |       |       |   |       |   |       |   |   |   |       |
+   +   +---+---+---+---+   +---+---+---+   +   +   +---+   +   +---+   +   +   +---+   +---+   +   +---+---+   +   +   +---+   +
|   |   |   |           |                   |   |           |   |       |   |   |       |       |           |       |       |   |
+   +   +   +   +   +---+---+---+   +---+---+   +---+---+---+   +   +---+   +   +   +---+   +---+   +   +---+---+---+---+   +   +
|   |   |       |   |           |   |   |       |           |       |       |   |           |       |                       |   |
+   +   +   +---+   +   +---+   +   +   +   +---+   +---+   +---+---+   +---+---+   +---+---+   +---+---+   +---+---+---+---+   +
|       |   |       |   |   |   |       |       |       |           |           |       |       |       |   |                   |
+   +---+   +   +---+   +   +   +---+   +---+   +   +   +---+   +---+---+---+   +---+   +---+---+   +   +   +   +---+---+---+---+
|   |       |       |   |       |   |       |   |   |       |   |           |   |   |       |       |       |                   |
+   +---+---+---+   +   +   +---+   +---+   +   +   +---+   +---+   +---+   +   +   +---+   +   +   +---+---+   +---+---+---+   +
|                   |   |       |           |   |   |   |       |   |   |       |               |   |       |               |   |
+---+---+---+---+   +   +---+   +   +---+---+   +   +   +---+   +   +   +---+---+---+---+---+---+---+   +   +---+---+---+---+   +
|           |       |   |       |       |       |   |       |       |               |           |       |   |       |           |
+   +---+   +   +---+   +---+   +---+---+   +---+   +---+   +---+---+   +---+---+   +   +---+   +   +---+   +   +   +   +---+   +
|   |   |       |   |       |               |   |                   |   |       |       |           |           |       |       |
+   +   +---+---+   +---+   +---+---+---+---+   +---+---+---+---+   +   +---+   +---+---+   +---+---+---+---+   +---+---+   +---+
|       |           |       |       |                           |   |       |           |   |           |       |       |       |
+---+   +---+---+   +   +---+   +---+   +---+   +---+---+---+   +   +---+   +   +---+---+   +   +---+   +---+---+   +   +---+   +
|   |       |       |       |           |   |           |       |           |               |   |       |           |       |   |
+   +---+   +   +---+---+   +   +---+---+   +---+---+   +   +---+   +---+---+---+---+---+   +   +   +---+   +---+---+---+   +---+
|       |       |       |   |                       |   |   |       |                   |   |   |       |       |       |       |
+   +   +---+   +   +   +   +---+---+---+---+---+   +   +---+   +---+   +---+---+---+   +---+   +---+   +---+   +   +   +---+   +
|   |           |   |       |       |               |           |   |   |   |           |           |   |       |   |   |       |
+   +---+---+---+   +---+---+   +   +   +---+---+---+   +---+---+   +   +   +   +---+---+   +---+---+   +   +---+   +---+   +   +
|   |     G |       |       |   |       |   |       |               |       |   |       |       |       |       |   |       |   |
+   +   +---+   +---+   +   +   +---+---+   +   +   +---+---+   +---+---+   +   +   +   +---+   +   +---+---+   +   +   +---+---+
|       |       |       |                   |   |   |       |   |       |   |       |       |   |           |   |   |           |
+   +---+   +---+   +---+---+---+---+---+---+   +   +   +   +---+   +   +   +---+---+---+   +   +---+---+   +   +   +---+---+   +
|   |       |           |       |           |   |       |           |       |           |       |       |       |       |       |
+   +   +---+---+---+   +   +   +   +---+   +   +---+---+---+---+---+---+---+   +---+   +   +---+---+   +---+---+   +   +   +---+
|   |           |       |   |       |   |   |   |       |               |       |   |   |               |           |   |       |
+---+---+---+   +   +---+   +---+---+   +   +   +   +   +   +   +---+---+   +---+   +   +---+---+---+   +---+   +   +---+---+   +
|               |       |       |       |           |       |   |           |       |               |           |   |           |
+   +---+---+---+---+---+---+   +   +   +---+---+---+---+---+   +   +---+---+---+   +---+---+---+   +---+---+   +---+   +---+   +
|   |                       |   |   |   |       |           |   |       |               |       |   |           |       |   |   |
+   +   +---+---+---+   +---+   +   +   +   +   +---+---+   +   +---+   +   +---+---+---+   +   +   +   +---+---+   +---+   +   +
|       |       |   |               |   |   |           |       |       |   |       |       |   |   |   |       |   |       |   |
+   +---+   +   +   +---+---+---+---+   +   +---+---+   +---+---+   +---+   +   +   +   +---+   +   +   +   +   +   +---+   +   +
|   |       |       |       |       |   |       |   |           |   |       |   |       |       |   |       |   |       |       |
+   +   +---+---+   +---+   +   +   +---+---+   +   +---+---+   +   +   +---+   +---+---+   +   +   +---+---+   +---+   +---+   +
|   |       |               |   |               |           |       |   |       |   |       |   |       |           |       |   |
+   +   +   +---+---+---+   +   +---+---+---+---+---+---+   +---+---+   +   +---+   +   +---+   +---+   +---+---+---+---+   +   +
|   |   |   |       |       |       |                   |               |           |       |       |       |               |   |
+   +---+   +   +   +   +---+---+   +   +---+---+---+   +   +---+---+   +---+---+   +---+   +---+---+---+   +   +---+---+---+---+
|       |       |   |           |                   |   |       |   |       |           |   |       |       |                   |
+---+   +   +---+   +   +---+---+   +---+---+---+   +   +---+   +   +---+   +   +---+---+   +   +   +   +---+---+---+---+---+   +
|       |   |       |   |       |   |       |       |       |           |       |       |       |   |                           |
+   +---+---+   +---+   +   +   +---+   +   +---+---+   +   +---+---+---+---+---+   +   +   +---+   +---+---+---+---+---+---+   +
|   |           |       |   |           |           |   |   |                       |   |   |   |                           |   |
+   +---+   +---+---+---+   +---+---+---+---+---+   +   +   +   +---+---+---+---+---+   +   +   +---+---+---+---+---+   +---+   +
|           |           |           |       |   |   |   |                           |   |                           |   |       |
+---+---+---+   +---+   +   +---+   +   +   +   +   +---+---+---+   +---+---+---+   +   +---+---+   +---+---+---+---+   +   +---+
|               |   |   |       |       |   |   |           |   |   |           |   |       |   |   |       |           |       |
+   +---+---+---+   +   +---+---+---+---+   +   +---+---+   +   +   +   +---+   +---+---+   +   +   +   +   +   +---+   +---+   +
|   |   |       |       |               |   |   |       |   |       |   |   |       |       |       |   |       |           |   |
+   +   +   +   +   +---+   +---+---+   +   +   +   +   +   +---+---+   +   +---+   +   +---+   +---+   +---+---+---+---+---+   +
| S |       |               |               |       |                   |               |           |                           |
+---+---+---+---+---+---+---+---+---+---+---+---+---+---+---+---+---+---+---+---+---+---+---+---+---+---+---+---+---+---+---+---+
