+---+---+---+---+---+---+---+---+---+---+---+---+---+---+---+---+---+---+---+---+---+---+---+---+---+---+---+---+---+---+---+---+
|                                                                                                                               |
+   +---+---+---+---+---+---+---+---+---+   +---+---+---+---+---+---+---+---+---+---+---+---+---+---+---+---+---+---+---+---+   +
|   |                                   |   |                                   |                                               |
+   +   +---+---+---+---+---+---+---+   +   +   +---+---+---+---+---+---+---+   +   +---+---+---+   +   +---+---+---+---+---+   +
|   |   |                           |   |   |   |                               |                   |                       |   |
+   +   +   +---+   +   +---+---+   +   +   +   +   +---+---+---+---+---+---+---+---+---+---+---+---+   +---+---+---+---+   +   +
|   |   |           |                   |   |   |                               |                       |                   |   |
+   +   +   +---+---+---+---+---+---+   +---+   +---+---+---+---+---+---+---+   +   +---+---+---+   +---+   +---+---+---+---+   +
|   |   |       |                   |       |   |                           |   |   |                   |   |               |   |
+   +   +---+   +   +---+---+---+   +---+   +   +   +   +   +   +   +   +   +   +   +   +---+---+---+   +   +   +   +   +   +   +
|   |   |       |   |           |       |       |                           |   |   |   |               |   |               |   |
+   +   +   +---+   +   +   +   +---+   +---+   +   +   +   +   +   +   +   +   +   +   +   +---+---+---+   +   +   +   +   +   +
|   |   |       |   |           |   |       |   |                           |   |       |   |           |   |               |   |
+   +   +   +---+   +   +   +   +   +---+   +---+   +   +   +   +   +   +   +   +   +---+   +   +---+   +   +   +   +   +   +   +
|   |       |       |         G |       |       |                           |           |               |   |               |   |
+   +   +---+   +---+---+---+   +   +   +---+   +---+   +   +   +   +   +   +   +---+   +---+---+   +   +   +   +   +   +   +   +
|   |   |       |                   |       |       |                       |       |               |   |   |               |   |
+   +   +   +---+   +---+   +---+   +---+   +---+   +---+   +   +   +   +   +   +   +   +---+---+---+   +   +   +   +   +   +   +
|   |   |   |                                   |       |                   |   |   |   |               |   |               |   |
+   +   +   +---+   +---+   +---+   +---+   +---+---+   +---+   +   +   +   +   +   +   +   +   +---+---+   +---+---+---+---+   +
|   |   |   |                                   |   |       |               |   |   |   |   |           |                       |
+   +   +   +   +---+   +---+   +---+   +---+   +   +---+   +---+---+---+---+   +   +   +   +   +   +   +---+---+---+---+   +   +
|   |   |   |                                   |       |       |               |   |   |       |   |       |               |   |
+   +   +   +   +---+   +---+   +---+   +---+   +   +   +---+   +---+   +---+---+   +   +---+---+   +   +   +   +---+---+   +   +
|   |   |   |                                   |   |       |       |   |   |   |   |               |   |   |   |       |   |   |
+   +   +   +---+   +---+   +---+   +---+   +---+   +---+   +---+   +---+   +   +   +   +---+---+   +   +   +   +   +   +   +   +
|   |   |   |                                   |       |       |       |       |   |   |       |   |   |       |   |       |   |
+   +   +   +---+   +---+   +---+   +---+   +---+---+   +---+   +---+   +---+   +   +   +   +---+   +   +---+---+   +---+   +   +
|   |   |   |                                   |           |       |       |           |       |   |               |   |   |   |
+   +   +   +   +---+   +---+   +---+   +---+   +   +---+   +---+   +---+   +---+---+---+   +   +   +---+---+---+---+   +   +   +
|   |   |   |                                   |               |       |       |           |   |                           |   |
+   +   +   +---+---+   +---+   +---+   +---+---+   +---+---+---+---+   +---+   +---+   +---+   +   +---+---+---+---+   +---+   +
|   |   |                   |       |               |                       |               |   |   |                   |       |
+   +   +---+---+---+---+---+   +   +---+---+---+   +   +---+---+---+---+---+---+   +---+   +   +   +---+   +---+---+---+   +   +
|   |                           |                   |   |                                   |   |       |               |   |   |
+   +---+---+---+---+---+---+---+---+---+   +---+   +   +   +---+---+---+---+---+---+   +---+   +---+   +---+---+---+   +   +   +
|               |                                   |   |   |                       |       |       |               |       |   |
+   +---+   +---+   +---+---+---+---+---+---+---+---+   +   +   +   +   +   +   +   +---+   +---+   +---+---+---+   +   +   +   +
|   |           |   |                           |       |   |                           |       |               |   |   |   |   |
+   +   +---+   +   +   +   +   +   +   +   +   +   +   +   +   +   +   +   +   +   +   +---+   +---+   +---+   +   +   +   +   +
|   |           |   |                           |   |   |   |                               |           |       |   |   |   |   |
+   +---+   +---+   +   +   +   +   +   +   +   +   +   +   +   +   +   +   +   +   +   +   +---+   +---+   +---+   +   +   +   +
|   |           |   |                           |   |   |   |                                   |       |           |       |   |
+   +   +---+   +   +   +   +   +   +   +   +   +   +   +   +   +   +   +   +   +   +   +   +   +---+   +   +   +---+---+   +   +
|   |           |   |                           |   |   |   |                                       |       |       |       |   |
+   +---+   +---+   +   +   +   +   +   +   +   +   +   +   +   +   +   +   +   +   +   +   +   +   +---+   +---+   +   +   +   +
|   |           |   |                           |   |   |   |                                           |       |   |   |   |   |
+   +   +---+   +   +   +   +   +   +   +   +   +   +   +   +---+---+---+---+---+---+---+---+---+---+---+---+   +---+   +   +   +
|   |           |   |                           |   |   |                                                   |       |       |   |
+   +---+   +---+   +---+---+---+---+---+---+---+   +   +---+---+---+---+   +---+---+---+---+---+---+---+   +---+   +   +   +   +
|   |           |                                   |                                                   |       |       |   |   |
+   +   +---+---+---+---+---+---+---+---+---+---+---+---+---+---+---+---+---+---+---+   +---+---+---+   +---+   +---+   +   +   +
|   |   |                                                               |           |   |           |       |       |   |   |   |
+   +   +   +---+---+---+---+---+   +   +---+---+---+---+---+---+   +   +   +   +   +   +   +   +   +---+   +---+   +   +   +   +
|   |       |                   |   |   |                       |   |   |   |   |   |   |   |   |       |           |   |   |   |
+   +---+---+   +---+---+---+   +   +   +   +---+---+---+---+   +   +   +   +   +   +   +   +   +   +   +---+---+   +   +   +   +
|   |       |   |           |   |   |   |                   |   |       |   |       |           |   |               |   |   |   |
+   +   +   +   +   +---+   +   +   +   +---+---+---+---+   +   +---+---+   +---+   +   +---+---+   +   +---+---+   +   +   +   +
|       |   |   |       |   |   |   |   |               |   |   |       |       |   |                               |   |   |   |
+   +---+   +   +---+   +   +   +   +   +   +---+---+   +   +   +   +   +   +   +   +---+   +---+---+---+   +---+   +   +   +   +
|   |       |           |   |   |   |   |   |           |   |   |   |   |   |   |                                   |   |       |
+   +   +---+---+---+---+   +   +   +   +   +   +---+---+   +   +   +   +   +   +---+---+---+---+---+---+---+---+   +   +---+   +
| S |                       |       |       |               |       |       |                                                   |
+---+---+---+---+---+---+---+---+---+---+---+---+---+---+---+---+---+---+---+---+---+---+---+---+---+---+---+---+---+---+---+---+
