+---+---+---+---+---+---+---+---+---+---+---+---+---+---+---+---+---+---+---+---+---+---+---+---+---+---+---+---+---+---+---+---+
|                                                           |                                   |                       |       |
+   +---+---+---+---+   +   +---+---+---+---+---+---+---+   +   +---+---+---+---+---+---+---+   +   +---+---+---+---+   +   +   +
|   |               |   |   |                           |   |   |                           |   |   |               |       |   |
+   +   +   +---+   +   +   +   +---+   +---+   +---+   +   +   +   +---+   +---+   +---+   +   +   +   +---+---+   +   +   +   +
|   |   |           |   |   |           |   |           |   |   |           |   |           |   |               |   |   |   |   |
+   +   +   +   +---+   +   +---+   +---+   +---+   +---+   +   +---+   +---+   +---+   +---+   +---+---+   +---+   +   +   +   +
|   |       |           |           |           |           |           |           |       |   |           |               |   |
+   +   +   +   +   +---+---+   +---+   +---+   +---+   +---+---+   +---+   +---+   +---+   +   +   +---+---+   +---+---+   +   +
|   |   |       |       |       |           |       |       |       |                       |                       |       |   |
+   +   +   +---+---+   +   +---+   +---+   +---+   +---+   +   +---+   +---+---+---+---+---+---+---+---+   +---+   +   +---+   +
|   |               |       |           |   |       |   |       |       |   |   |   |   |   |   |   |               |       |   |
+   +   +   +---+   +---+---+   +---+---+   +   +---+---+---+---+   +   +---+---+---+---+---+---+---+---+   +---+   +---+   +   +
|       |           |                       |                   |   |   |   |   |   |   |   |   |   |               |       |   |
+   +   +   +---+   +   +---+---+---+---+---+---+---+---+---+   +   +   +---+---+---+---+---+---+---+---+   +---+   +   +---+   +
|   |               |   |                   |               |   |   |   |   |   |   |   |   |   |   |               |       |   |
+   +   +   +---+   +   +   +---+---+---+   +   +---+---+   +   +   +   +---+---+---+---+---+---+---+---+   +---+   +---+   +   +
|       |           |   |   |               |           |   |   |   |   |   |   |   |   |   |   |   |               |       |   |
+   +---+---+---+---+   +   +   +---+---+---+---+---+   +   +   +   +   +---+---+---+---+---+---+---+---+   +---+---+---+   +   +
|                   |       |                           |   |   |   |   |   |   |   |   |   |   |   |           |       |   |   |
+---+---+---+---+   +---+---+---+---+---+---+---+---+---+   +   +   +   +---+---+---+---+---+---+---+---+   +---+   +   +   +   +
|               |                                           |   |   |   |   |   |   |   |   |   |   |           |   |       |   |
+---+---+---+   +   +---+---+---+---+---+   +---+---+---+---+   +   +   +---+---+---+---+---+---+---+---+   +---+   +---+---+   +
|           |   |   |   |   |   |   |   |   |                   |   |   |                                       |           |   |
+   +   +   +   +   +---+---+---+---+---+   +   +---+---+---+---+   +   +   +---+---+---+---+---+---+---+   +---+---+---+   +   +
|   |   |   |   |   |   |   |   |   |   |   |   |                   |   |           |                           |           |   |
+   +   +   +   +   +---+---+---+---+---+   +   +   +---+---+---+---+   +---+---+   +---+---+   +---+---+   +---+   +---+---+   +
|   |   |   |   |   |   |   |   |   |   |   |   |   |                   |           |                           |               |
+   +   +   +   +   +---+---+---+---+---+   +   +   +   +---+---+---+   +   +---+---+   +---+   +---+---+   +---+   +---+---+   +
|   |   |   |   |   |   |   |   |   |   |   |   |   |   |               |           |                           |           |   |
+   +   +   +   +   +---+---+---+---+---+   +   +   +   +   +---+---+   +---+---+   +   +---+---+---+---+   +---+   +---+   +   +
|   |   |   |   |   |   |   |   |   |   |   |   |   |   |                           |                           |   |   |   |   |
+   +   +   +   +   +---+---+---+---+---+   +   +   +   +   +---+---+---+---+---+---+   +---+---+   +---+   +---+   +---+   +   +
|   |   |   |   |   |   |   |   |   |   |   |   |   |   |           |                                           |           |   |
+   +   +   +   +   +---+---+---+---+---+   +   +   +   +---+---+   +   +---+---+---+---+---+---+---+---+---+---+---+---+---+   +
|   |   |   |   |   |   |   |   |   |   |   |   |   |   |       |   |   |                                                       |
+   +   +   +   +   +---+---+---+---+---+   +   +   +   +   +   +   +   +   +---+---+---+---+---+---+---+---+---+---+---+---+   +
|   |   |       |   |   |   |   |   |   |   |       |   |   |       |   |   |                                               |   |
+   +   +---+---+   +---+---+---+---+---+   +---+---+   +   +---+---+   +   +   +---+---+---+---+---+---+---+---+---+---+   +   +
|   |                                       |           |   |   |   |   |   |   |                                       |   |   |
+   +---+---+---+---+---+---+---+---+   +---+---+   +   +   +---+---+   +   +   +   +---+---+---+---+---+---+---+---+   +   +   +
|                                           |       |   |               |   |   |   |   |   |   |   |   |   |       |   |   |   |
+   +   +---+---+   +---+---+---+   +---+---+   +---+   +---+---+---+   +   +   +   +---+---+---+---+---+---+   +   +   +   +   +
|   |       |           |   |       |                               |   |   |   |   |   |   |   |   |   |   |   |   |   |   |   |
+   +   +   +   +---+   +---+   +---+   +---+---+---+---+---+---+   +   +   +   +   +---+---+---+---+---+---+   +   +   +   +   +
|       |               |       |   |           |               |   |   |   |   |   |   |   |   |   |   |   |   |   |   |   |   |
+   +   +   +---+   +---+   +---+   +---+---+   +   +---+---+   +   +   +   +   +   +---+---+---+---+---+---+   +   +   +   +   +
|   |                               |           |   |       |   |   |   |   |   |   |   |   |   |   |   |   |   |   |   |   |   |
+   +---+---+   +---+   +---+---+---+   +---+---+   +   +   +   +   +   +   +   +   +---+---+---+---+---+---+   +   +   +   +   +
|           |           |           |           |   |   |           |   |   |   |   |   |   |   |   |   |   |   |   |   |   |   |
+   +---+   +---+   +---+   +   +   +---+---+   +   +   +---+---+---+   +   +   +   +---+---+---+---+---+---+   +   +   +   +   +
|   |                   |           |           |   |                   |   |   |   |   |   |   |   |   |   |   |   |   |   |   |
+   +   +---+   +---+   +   +   +   +   +---+---+   +---+---+---+---+---+   +   +   +---+---+---+---+---+---+   +   +   +   +   +
|   |                   | G         |           |                       |   |   |   |   |   |   |   |   |   |   |   |   |   |   |
+   +---+   +---+   +---+   +---+---+---+---+   +   +---+---+---+---+   +   +   +   +---+---+---+---+---+---+   +   +   +   +   +
|   |                   |       |               |                   |   |   |   |                               |   |   |   |   |
+   +   +---+   +---+   +   +   +   +   +---+---+---+   +---+---+   +   +   +   +---+---+---+---+---+---+---+---+   +   +   +   +
|                       |   |                       |               |   |   |                                       |   |   |   |
+   +---+   +---+   +---+   +---+---+   +---+---+   +---+   +---+---+   +   +---+---+---+---+---+---+---+---+---+---+   +   +   +
|   |                   |                           |                   |                                               |   |   |
+   +   +---+   +---+   +   +---+---+---+   +---+---+---+---+   +---+   +---+---+---+---+---+---+---+---+---+---+---+---+   +   +
|                       |                                                                                                   |   |
+   +   +---+---+---+   +---+---+---+---+---+---+---+---+---+---+---+---+---+---+---+---+---+---+---+---+---+---+---+---+---+   +
| S |                                                                                                                           |
+---+---+---+---+---+---+---+---+---+---+---+---+---+---+---+---+---+---+---+---+---+---+---+---+---+---+---+---+---+---+---+---+
