+---+---+---+---+---+---+---+---+---+---+---+---+---+---+---+---+---+---+---+---+---+---+---+---+---+---+---+---+---+---+---+---+
|                                                                       |       |       |       |       |               |       |
+   +   +---+---+---+---+---+---+---+---+---+---+---+---+   +   +   +   +   +   +   +   +   +   +   +   +   +---+   +   +   +   +
|   |                                                   |   |   |   |       |       |       |       |       |       |   |   |   |
+   +---+---+---+---+---+---+---+---+---+---+---+---+   +   +---+   +---+   +   +   +   +   +   +   +   +---+   +---+   +   +   +
|   |                                               |   |               |       |       |       |       |       |       |   |   |
+   +   +---+---+---+---+---+---+---+---+---+---+   +   +---+---+---+   +   +   +   +   +   +   +   +---+   +---+   +---+   +   +
|   |   |       |                               |   |   |           |   |   |       |       |       |       |           |   |   |
+   +   +   +   +   +   +   +   +   +   +   +   +   +   +   +---+   +   +---+---+---+---+   +   +---+   +---+   +---+---+   +   +
|   |   |   |   |                               |   |   |   |       |                   |       |       |   |               |   |
+   +   +   +   +   +   +   +   +   +   +   +   +   +   +   +   +---+---+---+---+---+   +---+---+   +---+   +   +---+---+   +   +
|   |   |   |   |                               |   |   |   |   |   |       |       |   |               |   |   |           |   |
+   +   +   +   +   +   +   +   +   +   +   +   +   +   +   +   +   +   +   +   +   +   +---+   +---+---+   +   +   +---+---+   +
|   |   |   |   |                               |   |   |   |   |       |       |       |       |           |   |   |       |   |
+   +   +   +   +   +   +   +   +   +   +   +   +   +   +   +   +   +---+---+---+   +---+   +---+   +   +   +   +   +   +   +   +
|   |   |   |   |                               |   |   |   |               |       |           |           |   |   |   |   |   |
+   +   +   +   +---+---+---+---+   +   +   +   +   +   +   +---+---+---+   +   +---+   +---+---+   +   +   +   +   +   +   +   +
|   |   |   |                   |               |   |   |               |       |       |       |           |   |   |   |       |
+   +   +   +---+---+---+---+   +   +   +   +   +   +   +---+---+---+   +   +---+   +---+   +   +   +   +   +   +   +   +   +   +
|   |   |                   |   |               |   |   |               |   |       |       |   |           |   |       |   |   |
+   +   +---+---+---+---+   +   +---+---+---+---+   +   +   +---+---+---+---+   +---+   +---+   +   +   +   +   +---+---+---+   +
|   |                   |   |                       |   |           |           |           |   |           |               |   |
+   +   +---+---+---+   +   +---+---+---+---+---+---+   +---+---+   +---+   +---+   +---+   +   +   +   +   +---+---+---+   +   +
|   |   |               |                               |           |           |           |   |           |               |   |
+   +   +   +---+---+---+---+---+---+---+---+---+---+---+   +---+---+   +---+---+   +---+---+   +---+---+---+---+---+   +---+   +
|   |   |                                                   |           |       |   |       |                               |   |
+   +   +---+---+---+---+---+---+---+---+---+---+---+---+---+---+   +---+   +   +   +   +   +---+---+---+---+---+---+   +---+   +
|   |                           |       |       |       |   |       |       |   |       |                       |           |   |
+   +   +---+---+   +---+---+   +   +   +   +   +   +   +   +   +---+   +---+   +---+---+---+---+---+---+---+   +---+   +---+   +
|   |           |           |       |       |       |       |                                                   |           |   |
+   +   +---+   +---+---+   +---+---+---+---+---+---+---+   +---+---+---+---+---+---+   +   +---+---+---+---+   +---+   +---+   +
|   |       |           |   |                           |                           |   |   |       |           |           |   |
+   +---+   +---+---+   +   +   +   +   +   +   +   +   +---+---+---+---+---+---+   +   +   +   +   +   +---+---+---+---+   +   +
|       |           |       |                           |                           |           |       |                   |   |
+   +   +   +---+   +---+   +   +   +   +   +   +   +   +   +---+---+---+---+---+---+   +---+---+---+---+   +---+---+---+---+   +
|   |   |       |       |   |                           |                                               |               |       |
+   +   +---+   +---+   +---+   +   +   +   +   +   +   +   +   +---+---+---+---+---+---+---+---+---+   +---+---+---+   +   +   +
|   |   |   |               |                           |   |                       |               |   |               |   |   |
+   +   +   +---+   +---+   +---+---+---+---+---+   +   +   +---+   +---+   +---+   +   +   +   +   +   +   +---+---+---+   +   +
|   |   |       |       |                       |       |   |                       |               |   |   |           |   |   |
+   +   +   +   +---+   +---+   +---+---+---+   +   +   +   +   +---+   +---+   +---+   +   +   +   +   +   +   +---+   +   +   +
|   |   |           |       |       |       |   |       |   |                       |               |   |   |   |       |   |   |
+   +   +   +   +   +---+   +---+   +---+   +   +   +   +   +---+---+---+---+---+   +   +   +   +   +   +   +   +   +---+   +   +
|   |   |               |       |       |   |   |       |   |                       |               |   |       |           |   |
+   +   +   +   +   +   +---+   +---+   +---+   +---+---+   +   +---+---+---+---+   +   +   +   +   +   +---+---+---+---+   +   +
|   |   |                   |       |       |               |   |                   |               |   |                   |   |
+   +---+---+---+---+---+---+---+   +---+   +---+   +---+---+   +   +---+---+---+---+   +   +   +   +   +---+---+---+---+---+   +
|                               |       |       |       |   |   |                   |               |                       |   |
+---+---+---+---+---+---+---+   +---+   +---+   +---+   +---+   +---+---+---+---+   +   +   +   +---+---+---+---+---+---+   +   +
|                           |   |   |       |       |           |               |   |           |           |               |   |
+   +---+---+---+---+---+   +   +---+---+   +---+   +---+---+   +   +---+---+   +   +---+---+---+   +   +   +   +---+   +---+   +
|   |                   |   |   |       |       |           |   |   |       |   |       |       |           |               |   |
+   +   +---+---+---+   +   +   +   +   +---+   +---+---+   +---+   +   +   +   +   +   +   +   +   +   +   +---+   +---+   +   +
|   |   |           |   |   |   |   |       |           |           |   |   |   |   |       |   |         G |               |   |
+   +   +   +---+   +   +   +   +   +---+   +---+---+   +---+---+---+   +   +   +   +   +   +   +---+---+   +   +---+   +---+   +
|   |   |   |           |   |   |   |       |       |                       |   |       |       |                           |   |
+   +   +   +   +   +---+   +   +   +   +---+   +   +   +---+---+---+---+---+   +   +   +   +   +   +---+   +---+   +---+   +   +
|   |   |   |   |           |   |   |           |       |                   |       |       |                               |   |
+   +   +   +   +---+---+---+   +   +---+---+---+---+---+   +---+---+---+   +---+---+---+---+---+---+---+---+---+---+---+---+   +
|   |   |   |                   |                           |           |                                                   |   |
+   +   +   +---+---+---+---+---+---+---+---+---+---+---+---+   +---+   +---+---+---+---+---+---+---+---+---+---+---+---+   +   +
|   |   |                                                       |   |                                                       |   |
+   +   +---+---+---+---+---+---+---+---+---+---+---+---+---+---+   +---+---+---+---+---+---+---+---+---+---+---+---+---+---+   +
| S |                                                                                                                           |
+---+---+---+---+---+---+---+---+---+---+---+---+---+---+---+---+---+---+---+---+---+---+---+---+---+---+---+---+---+---+---+---+
