+---+---+---+---+---+---+---+---+---+---+---+---+---+---+---+---+---+---+---+---+---+---+---+---+---+---+---+---+---+---+---+---+
|                                                           |                                   |                       |       |
+   +---+---+---+---+   +   +---+---+---+---+---+---+---+   +   +---+---+---+---+---+---+---+   +   +---+---+---+---+   +   +   +
|   |               |   |   |                           |   |   |                           |   |   |               |       |   |
+   +   +   +---+   +   +   +   +---+   +---+   +---+   +   +   +   +---+   +---+   +---+   +   +   +   +---+---+   +   +   +   +
|   |   |           |   |   |           |   |           |   |   |           |   |           |   |               |   |   |   |   |
+   +   +   +   +---+   +   +---+   +---+   +---+   +---+   +   +---+   +---+   +---+   +---+   +---+---+   +---+   +   +   +   +
|   |       |           |           |           |           |           |           |       |   |           |               |   |
+   +   +   +   +   +---+---+   +---+   +---+   +---+   +---+---+   +---+   +---+   +---+   +   +   +---+---+   +---+---+   +   +
|   |   |       |       |       |           |       |       |       |                       |                       |       |   |
+   +   +   +---+---+   +   +---+   +---+   +---+   +---+   +   +---+   +---+---+---+---+---+---+---+---+   +---+   +   +---+   +
|   |               |       |           |   |       |   |       |       |                           |               |       |   |
+   +   +   +---+   +---+---+   +---+---+   +   +---+---+---+---+   +   +   +   +   +   +   +   +   +---+   +---+   +---+   +   +
|       |           |                       |                   |   |   |                           |               |       |   |
+   +   +   +---+   +   +---+---+---+---+---+---+---+---+---+   +   +   +   +   +   +   +   +   +   +---+   +---+   +   +---+   +
|   |               |   |                   |               |   |   |   |                           |               |       |   |
+   +   +   +---+   +   +   +---+---+---+   +   +---+---+   +   +   +   +   +   +   +   +   +   +   +---+   +---+   +---+   +   +
|       |           |   |   |               |           |   |   |   |   |                           |               |       |   |
+   +---+---+---+---+   +   +   +---+---+---+---+---+   +   +   +   +   +   +   +   +   +   +   +   +---+   +---+---+---+   +   +
|                   |       |                           |   |   |   |   |                           |           |       |   |   |
+---+---+---+---+   +---+---+---+---+---+---+---+---+---+   +   +   +   +   +   +   +   +   +   +   +---+   +---+   +   +   +   +
|               |                                           |   |   |   |                           |           |   |       |   |
+---+---+---+   +   +---+---+---+---+---+   +---+---+---+---+   +   +   +---+---+---+---+---+---+---+---+   +---+   +---+---+   +
|           |   |   |                   |   |                   |   |   |                                       |           |   |
+   +   +   +   +   +   +   +   +   +   +   +   +---+---+---+---+   +   +   +---+---+---+---+---+---+---+   +---+---+---+   +   +
|   |   |   |   |   |                   |   |   |                   |   |           |                           |           |   |
+   +   +   +   +   +   +   +   +   +   +   +   +   +---+---+---+---+   +---+---+   +---+---+   +---+---+   +---+   +---+---+   +
|   |   |   |   |   |                   |   |   |   |                   |           |                           |               |
+   +   +   +   +   +   +   +   +   +   +   +   +   +   +---+---+---+   +   +---+---+   +---+   +---+---+   +---+   +---+---+   +
|   |   |   |   |   |                   |   |   |   |   |               |           |                           |           |   |
+   +   +   +   +   +   +   +   +   +   +   +   +   +   +   +---+---+   +---+---+   +   +---+---+---+---+   +---+   +---+   +   +
|   |   |   |   |   |                   |   |   |   |   |                           |                           |   |   |   |   |
+   +   +   +   +   +   +   +   +   +   +   +   +   +   +   +---+---+---+---+---+---+   +---+---+   +---+   +---+   +---+   +   +
|   |   |   |   |   |                   |   |   |   |   |           |                                           |           |   |
+   +   +   +   +   +   +   +   +   +   +   +   +   +   +---+---+   +   +---+---+---+---+---+---+---+---+---+---+---+---+---+   +
|   |   |   |   |   |                   |   |   |   |   |       |   |   |                                                       |
+   +   +   +   +   +   +   +   +   +   +   +   +   +   +   +   +   +   +   +---+---+---+---+---+---+---+---+---+---+---+---+   +
|   |   |       |   |                   |   |       |   |   |       |   |   |                                               |   |
+   +   +---+---+   +---+---+---+---+---+   +---+---+   +   +---+---+   +   +   +---+---+---+---+---+---+---+---+---+---+   +   +
|   |                                       |           |   |   |   |   |   |   |                                       |   |   |
+   +---+---+---+---+---+---+---+---+   +---+---+   +   +   +---+---+   +   +   +   +---+---+---+---+---+---+---+---+   +   +   +
|                                           |       |   |               |   |   |   |                       |       |   |   |   |
+   +   +---+---+   +---+---+---+   +---+---+   +---+   +---+---+---+   +   +   +   +   +   +   +   +   +   +   +   +   +   +   +
|   |       |           |   |       |                               |   |   |   |   |                       |   |   |   |   |   |
+   +   +   +   +---+   +---+   +---+   +---+---+---+---+---+---+   +   +   +   +   +   +   +   +   +   +   +   +   +   +   +   +
|       |               |       |   |           |               |   |   |   |   |   |                       |   |   |   |   |   |
+   +   +   +---+   +---+   +---+   +---+---+   +   +---+---+   +   +   +   +   +   +   +   +   +   +   +   +   +   +   +   +   +
|   |                               |           |   |       |   |   |   |   |   |   |                       |   |   |   |   |   |
+   +---+---+   +---+   +---+---+---+   +---+---+   +   +   +   +   +   +   +   +   +   +   +   +   +   +   +   +   +   +   +   +
|           |           |           |           |   |   |           |   |   |   |   |                       |   |   |   |   |   |
+   +---+   +---+   +---+   +   +   +---+---+   +   +   +---+---+---+   +   +   +   +   +   +   +   +   +   +   +   +   +   +   +
|   |                   |           |           |   |                   |   |   |   |                       |   |   |   |   |   |
+   +   +---+   +---+   +   +   +   +   +---+---+   +---+---+---+---+---+   +   +   +   +   +   +   +   +   +   +   +   +   +   +
|   |                   | G         |           |                       |   |   |   |                       |   |   |   |   |   |
+   +---+   +---+   +---+   +---+---+---+---+   +   +---+---+---+---+   +   +   +   +---+---+---+---+---+---+   +   +   +   +   +
|   |                   |       |               |                   |   |   |   |                               |   |   |   |   |
+   +   +---+   +---+   +   +   +   +   +---+---+---+   +---+---+   +   +   +   +---+---+---+---+---+---+---+---+   +   +   +   +
|                       |   |                       |               |   |   |                                       |   |   |   |
+   +---+   +---+   +---+   +---+---+   +---+---+   +---+   +---+---+   +   +---+---+---+---+---+---+---+---+---+---+   +   +   +
|   |                   |                           |                   |                                               |   |   |
+   +   +---+   +---+   +   +---+---+---+   +---+---+---+---+   +---+   +---+---+---+---+---+---+---+---+---+---+---+---+   +   +
|                       |                                                                                                   |   |
+   +   +---+---+---+   +---+---+---+---+---+---+---+---+---+---+---+---+---+---+---+---+---+---+---+---+---+---+---+---+---+   +
| S |                                                                                                                           |
+---+---+---+---+---+---+---+---+---+---+---+---+---+---+---+---+---+---+---+---+---+---+---+---+---+---+---+---+---+---+---+---+
